누적 확진률,누적 검사수,누적 검사 완료 수,치료 중 환자 수,격리 해제 수,사망자 수,확진자 수,검사 진행 수,결과 음성 수,기준일,당일 확진자 수
1.852961395,12156200,11668133,24565,189506,2135,216206,488067,11451927,20210811,2223
1.83736894,12112086,11646164,24326,187523,2134,213983,465922,11432181,20210810,1537
1.83296045,12057829,11590321,24079,186242,2125,212446,467508,11377875,20210809,1491
1.824686826,12027441,11561162,23831,185003,2121,210955,466279,11350207,20210808,1727
1.811342421,11995928,11550991,23323,183789,2116,209228,444937,11341763,20210807,1823
1.79967185,11951651,11524601,23240,182052,2113,207405,427050,11317196,20210806,1704
1.789802041,11908436,11492947,22873,180719,2109,205701,415489,11287246,20210805,1775
1.778472603,11864245,11466356,22697,179123,2106,203926,397889,11262430,20210804,1725
1.770320677,11820016,11421716,22188,177909,2104,202201,398300,11219515,20210803,1200
1.765422381,11772604,11385434,22297,176605,2099,201001,387170,11184433,20210802,1218
1.756614815,11751782,11373182,22011,175674,2098,199783,378600,11173399,20210801,1442
1.746018527,11728817,11359616,22069,174177,2095,198341,369201,11161275,20210731,1539
1.737651082,11682964,11325749,21956,172757,2089,196802,357215,11128947,20210730,1710
1.727215688,11637499,11295173,21448,171559,2085,195092,342326,11100081,20210729,1673
1.717500974,11585607,11261653,20842,170494,2083,193419,323954,11068234,20210728,1895
1.707111067,11528602,11219188,20816,168629,2079,191524,309414,11027664,20210727,1363
1.699180205,11472341,11191338,20719,167365,2077,190161,281003,11001177,20210726,1318
1.689328905,11453342,11178581,20395,166375,2073,188843,274761,10989738,20210725,1487
1.679445943,11430519,11155822,20042,165246,2068,187356,274697,10968466,20210724,1629
1.671666837,11388299,11110288,19455,164206,2066,185727,278011,10924561,20210723,1630
1.662363054,11343912,11074416,18961,163073,2063,184097,269496,10890319,20210722,1841
1.649900996,11298668,11046481,18562,161634,2060,182256,252187,10864225,20210721,1781
1.639592235,11251981,11007310,18069,160347,2059,180475,244671,10826835,20210720,1278
1.634749742,11202428,10961739,17509,159630,2058,179197,240689,10782542,20210719,1251
1.626483085,11175976,10940538,16936,158953,2057,177946,235438,10762592,20210718,1454
1.615992994,11149218,10921582,16477,157960,2055,176492,227636,10745090,20210717,1449
1.607316323,11108581,10890389,15879,157113,2051,175043,218192,10715346,20210716,1535
1.598272067,11060453,10855974,14949,156509,2050,173508,204479,10682466,20210715,1599
1.587787588,11008857,10826952,14370,155491,2048,171909,181905,10655043,20210714,1613
1.578983139,10964299,10785169,13498,154752,2046,170296,179130,10614873,20210713,1150
1.574150085,10919898,10745227,12915,154187,2044,169146,174671,10576081,20210712,1100
1.56668484,10902278,10726216,12243,153760,2043,168046,176062,10558170,20210711,1324
1.556415511,10881640,10711921,11531,153153,2038,166722,169719,10545199,20210710,1378
1.547621532,10844217,10683749,10810,152498,2036,165344,160468,10518405,20210709,1316
1.539934192,10802782,10651624,10071,151923,2034,164028,151158,10487596,20210708,1275
1.531972597,10766502,10623754,9220,151500,2033,162753,142748,10461001,20210707,1212
1.524832365,10735716,10594017,8749,150760,2032,161541,141699,10432476,20210706,746
1.521924583,10700134,10565241,8723,150044,2028,160795,134893,10404446,20210705,711
1.517552471,10685125,10548828,8444,149614,2026,160084,136297,10388744,20210704,742
1.51225601,10670617,10536708,8185,149132,2025,159342,133909,10377366,20210703,794
1.508409908,10641602,10510936,8205,148319,2024,158548,130666,10352388,20210702,826
1.503633528,10614316,10489391,7677,148024,2021,157722,124925,10331669,20210701,761
1.499871667,10579072,10464962,7250,147693,2018,156961,114110,10308001,20210630,794
1.496012552,10555741,10438883,7073,147077,2017,156167,116858,10282716,20210629,595
1.495009747,10520929,10406086,6882,146675,2015,155572,114843,10250514,20210628,501
1.492171802,10508678,10392302,6718,146340,2013,155071,116376,10237231,20210627,614
1.487889877,10495516,10380943,6456,145989,2012,154457,114573,10226486,20210626,668
1.48669463,10466545,10344357,6391,145389,2009,153789,122188,10190568,20210625,634
1.484374932,10438782,10317811,6359,144788,2008,153155,120971,10164656,20210624,610
1.483877972,10409949,10280158,6159,144379,2007,152545,129791,10127613,20210623,645
1.481529887,10380042,10252915,6077,143817,2006,151900,127127,10101015,20210622,394
1.482792362,10346047,10217614,6234,143268,2004,151506,128433,10066108,20210621,357
1.48118902,10335634,10204572,6248,142899,2002,151149,131062,10053423,20210620,429
1.478453976,10323154,10194433,6338,142385,1997,150720,128721,10043713,20210619,482
1.477526381,10294048,10168211,6426,141816,1996,150238,125837,10017973,20210618,507
1.477144467,10257836,10136517,6708,141029,1994,149731,121319,9986786,20210617,540
1.475587056,10229384,10110620,6760,140438,1993,149191,118764,9961429,20210616,545
1.475716049,10196469,10072805,6921,139733,1992,148646,123664,9924159,20210615,373
1.476517846,10165497,10042073,7263,139022,1988,148273,123424,9893800,20210614,399
1.474553742,10152907,10028390,7308,138581,1985,147874,124517,9880516,20210613,452
1.471521964,10140535,10018335,7403,138037,1982,147422,122200,9870913,20210612,565
1.471909911,10111062,9977309,7652,137224,1981,146857,133753,9830452,20210611,554
1.470894135,10076862,9946535,7611,136713,1979,146303,130327,9800232,20210610,611
1.469653222,10044783,9913359,7541,136174,1977,145692,131424,9767667,20210609,602
1.470110969,10008583,9869323,7703,135412,1975,145090,139260,9724233,20210608,453
1.470520206,9972297,9835771,7802,134861,1974,144637,136526,9691134,20210607,485
1.467459997,9959697,9823232,7917,134262,1973,144152,136465,9679080,20210606,556
1.463952231,9945954,9808790,7862,133763,1971,143596,137164,9665194,20210605,744
1.461030859,9911324,9777480,7594,133289,1969,142852,133844,9634628,20210604,695
1.459142631,9872324,9742502,7490,132699,1968,142157,129822,9600345,20210603,681
1.457699002,9834350,9705433,7443,132068,1965,141476,128917,9563957,20210602,677
1.455920354,9798402,9670790,7373,131463,1963,140799,127612,9529991,20210601,459
1.456836017,9761158,9633205,7558,130823,1959,140340,127953,9492865,20210531,430
1.45419645,9747614,9621121,7572,130381,1957,139910,126493,9481211,20210530,479
1.450924946,9733591,9609801,7741,129739,1951,139431,123790,9470370,20210529,533
1.449937701,9702456,9579584,8193,128759,1946,138898,122872,9440686,20210528,587
1.449339906,9665693,9543034,8188,128180,1943,138311,122659,9404723,20210527,637
1.447922627,9629450,9508381,8160,127574,1940,137674,121069,9370707,20210526,699
1.445550475,9592727,9475629,8044,126993,1938,136975,117098,9338654,20210525,516
1.44662691,9553613,9432909,8098,126427,1934,136459,120704,9296450,20210524,530
1.443892882,9536299,9414064,8117,125881,1931,135929,122235,9278135,20210523,585
1.439307962,9520966,9403408,8386,125032,1926,135344,117558,9268064,20210522,666
1.436877385,9487108,9372964,8598,124158,1922,134678,114144,9238286,20210521,561
1.43617514,9447358,9338485,8542,123659,1916,134117,108873,9204368,20210520,646
1.431454878,9428644,9324150,8322,123237,1912,133471,104494,9190679,20210519,653
1.429443031,9395004,9291591,8283,122631,1904,132818,103413,9158773,20210518,528
1.4299309,9353300,9251496,8224,122163,1903,132290,101804,9119206,20210517,619
1.425789915,9336614,9234951,8007,121764,1900,131671,101663,9103280,20210516,610
1.42150471,9319094,9219878,7883,121282,1896,131061,99216,9088817,20210515,681
1.419320945,9281291,9186083,8092,120395,1893,130380,95208,9055703,20210514,747
1.416191336,9241153,9153636,7836,119906,1891,129633,87517,9024003,20210513,715
1.413999381,9201539,9117260,7661,119373,1884,128918,84279,8988342,20210512,636
1.412850883,9164284,9079656,7686,118717,1879,128282,84628,8951374,20210511,510
1.413616464,9122059,9038661,8053,117844,1875,127772,83398,8910889,20210510,463
1.410705601,9105771,9024491,8012,117423,1874,127309,81280,8897182,20210509,564
1.406573167,9089166,9010907,7999,116881,1865,126745,78259,8884162,20210508,701
1.404787852,9051354,8972458,8162,116022,1860,126044,78896,8846414,20210507,525
1.404968493,9010992,8933937,8177,115491,1851,125519,77055,8808418,20210506,574
1.401502668,8994069,8915074,8154,114944,1847,124945,78995,8790129,20210505,676
1.399573986,8957155,8879059,8301,114128,1840,124269,78096,8754790,20210504,541
1.401809863,8915326,8826304,8538,113356,1834,123728,89022,8702576,20210503,488
1.398606636,8898234,8811627,8542,112865,1833,123240,86607,8688387,20210502,606
1.39385709,8883388,8798176,8466,112337,1831,122634,85212,8675542,20210501,627
1.391855443,8848292,8765781,8757,111422,1828,122007,82511,8643774,20210430,661
1.390724211,8805774,8725382,8734,110787,1825,121346,80392,8604036,20210429,680
1.388669431,8766491,8689325,8597,110248,1821,120666,77166,8568659,20210428,768
1.386889523,8721609,8645101,8383,109695,1820,119898,76508,8525203,20210427,512
1.389034001,8672978,8594894,8719,108850,1817,119386,78084,8475508,20210426,499
1.386076695,8654791,8577231,8599,108475,1813,118887,77560,8458344,20210425,644
1.382206691,8632923,8554654,8650,107781,1812,118243,78269,8436411,20210424,785
1.37965284,8583530,8513591,8576,107071,1811,117458,69939,8396133,20210423,797
1.377284051,8537505,8470366,8394,106459,1808,116661,67139,8353705,20210422,735
1.375097668,8497594,8430383,8243,105877,1806,115926,67211,8314457,20210421,43597
1.475531703,5061279,4901894,12827,58253,1249,72329,159385,4829565,20210117,-42866
1.372676031,8458592,8392002,8166,105227,1802,115195,66590,8276807,20210420,549
1.373983738,8414821,8344058,8371,104474,1801,114646,70763,8229412,20210419,532
1.370923999,8396066,8323875,8311,104006,1797,114114,72191,8209761,20210418,671
1.365674304,8377778,8306739,8055,103594,1794,113443,71039,8193296,20210417,658
1.365031284,8333331,8262448,7933,103062,1790,112785,70883,8149663,20210416,673
1.363743629,8291121,8220900,7811,102513,1788,112112,70221,8108788,20210415,698
1.363570274,8245383,8170756,7649,101983,1782,111414,74627,8059342,20210414,731
1.363942757,8200514,8114930,7576,101332,1775,110683,85584,8004247,20210413,542
1.366932546,8152778,8057530,7567,100804,1770,110141,95248,7947389,20210412,587
1.363015759,8129527,8037618,7677,100109,1768,109554,91909,7928064,20210411,614
1.358928355,8106625,8016611,7874,99301,1765,108940,90014,7907671,20210410,677
1.357156244,8059107,7977195,7713,98786,1764,108263,81912,7868932,20210409,671
1.35601577,8012415,7934421,7474,98360,1758,107592,77994,7826829,20210408,700
1.354517426,7966161,7891519,7208,97928,1756,106892,74642,7784627,20210407,668
1.354530128,7921284,7842129,7109,97363,1752,106224,79155,7735905,20210406,477
1.357764282,7868815,7788318,7099,96900,1748,105747,80497,7682571,20210405,474
1.354922235,7849470,7769671,6940,96589,1744,105273,79799,7664398,20210404,542
1.350616973,7829596,7754308,6795,96196,1740,104731,75288,7649577,20210403,543
1.350016028,7788290,7717538,6590,95861,1737,104188,70752,7613350,20210402,557
1.349601674,7747295,7678636,6457,95439,1735,103631,68659,7575005,20210401,551
1.349834806,7707792,7636490,6319,95030,1731,103080,71302,7533410,20210331,506
1.352225878,7663991,7585567,6282,94563,1729,102574,78424,7482993,20210330,447
1.354940491,7616317,7537379,6277,94124,1726,102127,78938,7435252,20210329,382
1.353535775,7595584,7516979,6168,93855,1722,101745,78605,7415234,20210328,482
1.350644798,7572556,7497382,6067,93475,1721,101263,75174,7396119,20210327,505
1.352096664,7529391,7451982,6412,92630,1716,100758,77409,7351224,20210326,489
1.355193611,7485852,7398869,6492,92068,1709,100269,86983,7298600,20210325,430
1.358931149,7441203,7346877,6572,91560,1707,99839,94326,7247038,20210324,428
1.361643807,7400980,7300808,6628,91079,1704,99411,100172,7201397,20210323,346
1.365882135,7355954,7252822,6757,90611,1697,99065,103132,7153757,20210322,415
1.363625494,7332699,7234391,6626,90328,1696,98650,98308,7135741,20210321,456
1.360797249,7308935,7215917,6552,89949,1693,98194,93018,7117723,20210320,447
1.362025697,7264931,7176590,6534,89523,1690,97747,88341,7078843,20210319,463
1.364746846,7218077,7128355,6418,89178,1688,97284,89722,7031071,20210318,445
1.366231389,7171500,7088038,6339,88814,1686,96839,83462,6991199,20210317,469
1.36733379,7126067,7048023,6437,88255,1678,96370,78044,6951653,20210316,363
1.368919801,7084930,7013340,6578,87754,1675,96007,71590,6917333,20210315,379
1.366787722,7066394,6996551,6551,87408,1669,95628,69843,6900923,20210314,459
1.363667431,7046775,6978901,6877,86625,1667,95169,67874,6883732,20210313,490
1.363480766,7012657,6943919,7274,85743,1662,94679,68738,6849240,20210312,488
1.363362007,6976978,6908730,7864,84675,1652,94191,68248,6814539,20210311,465
1.36455775,6938877,6868599,7766,84312,1648,93726,70278,6774873,20210310,470
1.364893195,6902977,6832476,7711,83900,1645,93256,70501,6739220,20210309,446
1.365976256,6861802,6794408,7694,83474,1642,92810,67394,6701598,20210308,346
1.364435288,6843119,6776723,7610,83220,1634,92464,66396,6684259,20210307,416
1.362308738,6821936,6756765,7503,82913,1632,92048,65171,6664717,20210306,418
1.36246771,6789004,6725297,7443,82560,1627,91630,63707,6633667,20210305,398
1.363339392,6751893,6691804,7451,82162,1619,91232,60089,6600572,20210304,424
1.36546628,6716196,6650329,7496,81700,1612,90808,65867,6559521,20210303,444
1.367382826,6681969,6608537,7420,81338,1606,90364,73432,6518173,20210302,344
1.365594246,6665747,6592002,7345,81070,1605,90020,73745,6501982,20210301,355
1.363496671,6648996,6576107,7365,80697,1603,89665,72889,6486442,20210228,355
1.361802856,6627207,6558218,7382,80333,1595,89310,68989,6468908,20210227,415
1.363190259,6590042,6521100,7430,79880,1585,88895,68942,6432205,20210226,387
1.365330286,6551206,6482534,7440,79487,1581,88508,68672,6394026,20210225,395
1.369066125,6510981,6435993,7487,79050,1576,88113,74988,6347880,20210224,440
1.370189069,6472671,6398606,7706,78394,1573,87673,74065,6310933,20210223,356
1.373626719,6429137,6356676,7868,77887,1562,87317,72461,6269359,20210222,332
1.37244108,6411333,6337977,7912,77516,1557,86985,73356,6250992,20210221,415
1.370974179,6390625,6314488,7934,77083,1553,86570,76137,6227918,20210220,449
1.372474868,6345985,6274869,8058,76513,1550,86121,71116,6188748,20210219,561
1.372806714,6303207,6232487,8120,75896,1544,85560,70720,6146927,20210218,621
1.372607322,6260560,6188150,8041,75360,1538,84939,72410,6103211,20210217,621
1.374021321,6213483,6136586,8233,74551,1534,84318,76897,6052268,20210216,457
1.37867916,6162852,6082706,8540,73794,1527,83861,80146,5998845,20210215,343
1.377757623,6140079,6061879,8437,73559,1522,83518,78200,5978361,20210214,326
1.37619376,6115330,6045079,8451,73227,1514,83192,70251,5961887,20210213,362
1.377629709,6093362,6012501,8387,72936,1507,82830,80861,5929671,20210212,403
1.376447447,6070001,5988387,8293,72638,1496,82427,81614,5905960,20210211,504
1.376871027,6030016,5949940,8211,72226,1486,81923,80076,5868017,20210210,444
1.379884866,5987398,5904768,8321,71676,1482,81479,82630,5823289,20210209,303
1.386830949,5938188,5853345,8484,71218,1474,81176,84843,5772169,20210208,288
1.388345369,5916967,5826216,8552,70865,1471,80888,90751,5745328,20210207,371
1.389261533,5893346,5795669,8548,70505,1464,80517,97677,5715152,20210206,390
1.396009594,5847174,5739717,8551,70117,1459,80127,107457,5659590,20210205,370
1.40354193,5803090,5682552,8605,69704,1448,79757,120538,5602795,20210204,451
1.411676332,5756709,5617860,8566,69299,1441,79306,138849,5538554,20210203,467
1.418696622,5711408,5557143,8629,68775,1435,78839,154265,5478304,20210202,336
1.424121446,5661837,5512381,8769,68309,1425,78503,149456,5433878,20210201,305
1.424043977,5640813,5491263,8900,67878,1420,78198,149550,5413065,20210131,354
1.422918225,5616524,5470729,9309,67121,1414,77844,145795,5392885,20210130,456
1.426111544,5569257,5426504,9486,66503,1399,77388,142753,5349116,20210129,469
1.428988634,5522182,5382758,9517,66016,1386,76919,139424,5305839,20210128,497
1.433589961,5469240,5330813,9566,65478,1378,76422,138427,5254391,20210127,559
1.435674359,5422761,5284137,9699,64793,1371,75863,138624,5208274,20210126,349
1.440686212,5376079,5241530,11198,62956,1360,75514,134549,5166016,20210125,437
1.438648888,5354342,5218577,11198,62530,1349,75077,135765,5143500,20210124,392
1.438166357,5329700,5193071,11304,62044,1337,74685,136629,5118386,20210123,431
1.442081737,5282216,5149084,11511,61415,1328,74254,133132,5074830,20210122,346
1.450163719,5237598,5096528,11746,60846,1316,73908,141070,5022620,20210121,400
1.457341804,5192119,5043978,12028,60180,1300,73508,148141,4970470,20210120,404
1.466194141,5140315,4985970,12353,59468,1283,73104,154345,4912866,20210119,386
1.475257315,5087209,4929174,12731,58723,1264,72718,158035,4856456,20210118,909
1.4725158,5032259,4876620,13019,57554,1236,71809,155639,4804811,20210116,580
1.479087326,4978063,4815740,13476,56536,1217,71229,162323,4744511,20210115,512
1.487023946,4925348,4755606,13750,55772,1195,70717,169742,4684889,20210114,524
1.496848095,4872301,4689387,14372,54636,1185,70193,182914,4619194,20210113,561
1.504809395,4814067,4627297,14898,53569,1165,69632,186770,4557665,20210112,537
1.514609144,4751666,4561903,15403,52552,1140,69095,189763,4492808,20210111,451
1.51465471,4723444,4531990,17110,50409,1125,68644,191454,4463346,20210110,657
1.50958738,4689604,4503681,17563,49324,1100,67987,185923,4435694,20210109,641
1.516958964,4629992,4439540,17896,48369,1081,67346,190452,4372194,20210108,674
1.522875336,4569796,4378034,17977,47649,1046,66672,191762,4311362,20210107,869
1.525770786,4504853,4312771,17781,46995,1027,65803,192082,4246968,20210106,838
1.530173855,4439347,4245596,17786,46172,1007,64965,193751,4180631,20210105,714
1.534952291,4376595,4185863,18030,45240,981,64251,190732,4121612,20210104,1020
1.52204206,4340825,4154353,17762,44507,962,63231,186472,4091122,20210103,657
1.51753665,4302780,4123393,18054,43578,942,62574,179387,4060819,20210102,820
1.509001128,4269303,4092376,17884,42953,917,61754,176927,4030622,20210101,1027
1.501831692,4213867,4043529,17557,42270,900,60727,170338,3982802,20201231,967
1.49859394,4159509,3987738,17446,41435,879,59760,171771,3927978,20201230,1050
1.494956717,4098166,3927204,17148,40703,859,58710,170962,3868494,20201229,1044
1.490687661,4038294,3868416,17579,39268,819,57666,169878,3810750,20201228,806
1.480951309,4006400,3839424,17012,39040,808,56860,166976,3782564,20201227,970
1.466009127,3969403,3812391,16565,38532,793,55890,157012,3756501,20201226,1131
1.447671509,3939346,3782557,15938,38048,773,54759,156789,3727798,20201225,1240
1.434186313,3882196,3731663,15338,37425,756,53519,150533,3678144,20201224,985
1.430100938,3826556,3673447,15069,36726,739,52534,153109,3620913,20201223,1090
1.420599914,3772416,3621287,14794,35928,722,51444,151129,3569843,20201222,866
1.417778888,3713849,3567411,14725,35155,698,50578,146438,3516833,20201221,924
1.401227224,3683083,3543608,14258,34722,674,49654,139475,3493954,20201220,1097
1.379459443,3646235,3520002,13564,34334,659,48557,126233,3471445,20201219,1045
1.365611493,3589792,3479174,12885,33982,645,47512,110618,3431662,20201218,1064
1.35039861,3538835,3439577,12204,33610,634,46448,99258,3393129,20201217,1014
1.338665524,3488761,3393977,11875,32947,612,45434,94784,3348543,20201216,1078
1.324953947,3441212,3347739,11197,32559,600,44356,93473,3303383,20201215,880
1.314354263,3397031,3307784,10787,32102,587,43476,89247,3264308,20201214,718
1.301828186,3374585,3284458,10364,31814,580,42758,90127,3241700,20201213,1030
1.278778492,3349856,3263114,9657,31493,578,41728,86742,3221386,20201212,950
1.261103622,3311205,3233517,9049,31157,572,40778,77688,3192739,20201211,689
1.250758929,3277938,3205174,8888,30637,564,40089,72764,3165085,20201210,1211
1.234153658,3221449,3150175,8676,29650,552,38878,71274,3111297,20201208,-531
1.240004745,3253213,3178133,8676,30177,556,39409,75080,3138724,20201209,1257
1.214506979,3209367,3141357,8302,29301,549,38152,68010,3103205,20201207,615
1.200361224,3194858,3127142,7864,29128,545,37537,67716,3089605,20201206,631
1.185080052,3180487,3114220,7449,28917,540,36906,66267,3077314,20201205,577
1.174407365,3157407,3093390,7182,28611,536,36329,64017,3057061,20201204,628
1.164379719,3131884,3066096,6820,28352,529,35701,65788,3030395,20201203,540
1.155922091,3106968,3041814,6570,28065,526,35161,65154,3006653,20201202,511
1.147691881,3083995,3019103,6239,27885,526,34650,64892,2984453,20201201,451
1.140801353,3061170,2997805,6048,27625,526,34199,63365,2963606,20201130,438
1.131370852,3046908,2984079,5696,27542,523,33761,62829,2950318,20201129,450
1.120395702,3031940,2973146,5440,27349,522,33311,58794,2939835,20201128,503
1.111057679,3009499,2952862,5189,27103,516,32808,56637,2920054,20201127,555
1.099801168,2987982,2932621,4788,26950,515,32253,55361,2900368,20201126,581
1.088196409,2966342,2910504,4334,26825,513,31672,55838,2878832,20201125,382
1.083236082,2946336,2888567,4058,26722,510,31290,57769,2857277,20201124,349
1.079732567,2922072,2865617,3893,26539,509,30941,56455,2834676,20201123,271
1.074331704,2908827,2854798,3699,26466,505,30670,54029,2824128,20201122,330
1.066305655,2896683,2845338,3472,26365,503,30340,51345,2814998,20201121,386
1.060229637,2873380,2825237,3190,26263,501,29954,48143,2795283,20201120,348
1.05424336,2853795,2808270,3010,26098,498,29606,45525,2778664,20201119,325
1.048880158,2834332,2791644,2812,25973,496,29281,42688,2762363,20201118,285
1.045069995,2815753,2774551,2642,25860,494,28996,41202,2745555,20201117,230
1.042482824,2797688,2759374,2513,25759,494,28766,38314,2730608,20201116,222
1.037775705,2786876,2750498,2360,25691,493,28544,36378,2721954,20201115,208
1.033182078,2777287,2742595,2208,25636,492,28336,34692,2714259,20201114,205
1.029952879,2761409,2731290,2106,25537,488,28131,30119,2703159,20201113,191
1.027022378,2749770,2720486,2049,25404,487,27940,29284,2692546,20201112,143
1.026536241,2736532,2707844,2044,25266,487,27797,28688,2680047,20201111,145
1.025628091,2723959,2696104,2007,25160,485,27652,27855,2668452,20201110,100
1.02675863,2709198,2683396,2043,25029,480,27552,25802,2655844,20201109,126
1.024416645,2702879,2677231,1980,24968,478,27426,25648,2649805,20201108,143
1.021440784,2697248,2671031,1896,24910,477,27283,26217,2643748,20201107,89
1.02206801,2686313,2660684,1897,24821,476,27194,25629,2633490,20201106,145
1.021239933,2673705,2648643,1839,24735,475,27049,25062,2621594,20201105,125
1.020619749,2662260,2638005,1825,24616,474,26924,24255,2611081,20201104,117
1.021591101,2649859,2624044,1869,24510,472,26807,25815,2597237,20201103,75
1.023772886,2636650,2611126,1812,24395,468,26732,25524,2584394,20201102,97
1.02214605,2630630,2605792,1736,24357,466,26635,24838,2579157,20201101,124
1.020119177,2624492,2598814,1694,24311,464,26511,25678,2572303,20201031,127
1.020318981,2612231,2585858,1641,24227,463,26384,26373,2559474,20201030,113
1.021490534,2597978,2571830,1612,24168,462,26271,26148,2545559,20201029,125
1.021305784,2582960,2560056,1602,24073,461,26146,22904,2533910,20201028,103
1.023467883,2567587,2544584,1593,23981,460,26043,23003,2518541,20201027,88
1.025281049,2552264,2531501,1510,23905,457,25955,20763,2505546,20201026,119
1.023425171,2546146,2524464,1484,23869,457,25836,21682,2498628,20201025,61
1.023308405,2540679,2518791,1526,23834,457,25775,21888,2493016,20201024,77
1.024563121,2528621,2508191,1443,23717,455,25698,20430,2482493,20201023,155
1.02355749,2515325,2495512,1388,23647,453,25543,19813,2469969,20201022,121
1.0234316,2503489,2483996,1420,23584,450,25422,19493,2458574,20201021,89
1.024825926,2491311,2471932,1463,23466,447,25333,19379,2446599,20201020,58
1.026411361,2479226,2462463,1443,23368,444,25275,16763,2437188,20201019,76
1.025705526,2474529,2456748,1407,23312,444,25199,17781,2431549,20201018,91
1.02431086,2468527,2451209,1414,23258,443,25108,17318,2426101,20201017,73
1.025154469,2459426,2442071,1467,23180,441,25035,17355,2417036,20201016,47
1.027265623,2450739,2432477,1410,23082,439,24988,18262,2407489,20201015,110
1.02672379,2441443,2423047,1508,23030,438,24878,18396,2398169,20201014,73
1.02983127,2428771,2408647,1542,22863,434,24805,20124,2383842,20201013,102
1.030830181,2415610,2396418,1481,22728,433,24703,19192,2371715,20201012,98
1.028989871,2410483,2391180,1494,22692,432,24605,19303,2366575,20201011,58
1.028921466,2404684,2385702,1479,22623,430,24547,18982,2361155,20201010,72
1.028562735,2400233,2379534,1532,22568,428,24475,20699,2355059,20201009,54
1.031350592,2388844,2367866,1594,22462,427,24421,20978,2343445,20201008,69
1.033644816,2378073,2355935,1734,22333,425,24352,22138,2331583,20201007,114
1.034619942,2365433,2342696,1856,22082,422,24238,22737,2318458,20201006,75
1.037069338,2352378,2329931,1825,21885,422,24163,22447,2305768,20201005,73
1.03647274,2346345,2324229,1820,21844,421,24090,22116,2300139,20201004,64
1.036241273,2339859,2318572,1803,21786,420,24026,21287,2294546,20201003,75
1.035145057,2333777,2313782,1808,21732,416,23951,19995,2289831,20201002,63
1.034826629,2328435,2308406,1808,21665,415,23888,20029,2284518,20201001,77
1.034180376,2322999,2302403,1822,21590,413,23811,20596,2278592,20200930,113
1.033498649,2313044,2292988,1963,21469,407,23698,20056,2269290,20200929,38
1.036484609,2301303,2282716,1962,21291,406,23660,18587,2259056,20200928,50
1.036599742,2296517,2277639,1951,21247,401,23610,18878,2254029,20200927,95
1.035065456,2290345,2271837,2082,21165,399,23515,18508,2248322,20200926,61
1.037465813,2280276,2260701,2116,20977,395,23454,19575,2237247,20200925,114
1.038156014,2268999,2248217,2178,20831,393,23340,20782,2224877,20200924,125
1.038065223,2256899,2236372,2277,20649,388,23215,20527,2213157,20200923,110
1.039880462,2245112,2221890,2412,20440,388,23105,23222,2198785,20200922,61
1.043161934,2231589,2209053,2434,20247,385,23044,22536,2186009,20200921,70
1.043121974,2226701,2202427,2545,20157,383,22974,24274,2179453,20200920,82
1.043173778,2219162,2194457,2635,19969,378,22892,24705,2171565,20200919,110
1.044584913,2206365,2180962,2742,19770,377,22782,25403,2158180,20200918,126
1.045797975,2191892,2166384,2827,19542,372,22656,25508,2143728,20200917,153
1.045197609,2178832,2152990,3146,19309,367,22503,25842,2130487,20200916,113
1.047599084,2164578,2137268,3433,18877,367,22390,27310,2114878,20200915,106
1.049386728,2151002,2123526,3592,18488,363,22284,27476,2101242,20200914,109
1.048183346,2143270,2115565,3671,18225,358,22175,27705,2093390,20200913,121
1.046388101,2135457,2107631,3953,18028,355,22054,27826,2085577,20200912,136
1.048814521,2119211,2089788,4037,17615,350,21918,29423,2067870,20200911,176
1.052079941,2099591,2066573,4221,17359,346,21742,33018,2044831,20200910,155
1.0552373,2082234,2045701,4455,17022,344,21587,36533,2024114,20200909,156
1.059520208,2066078,2022708,4663,16635,341,21431,43370,2001277,20200908,136
1.062525072,2051297,2004188,4697,16296,336,21295,47109,1982893,20200907,119
1.060754971,2045935,1996314,4668,16145,334,21176,49621,1975138,20200906,167
1.058404972,2037045,1984968,4727,16008,333,21009,52077,1963959,20200905,168
1.059726234,2018906,1966640,4785,15783,331,20841,52266,1945799,20200904,198
1.061321482,2000552,1945028,4766,15529,329,20643,55524,1924385,20200903,195
1.063036151,1980295,1923547,4659,15356,326,20448,56748,1903099,20200902,267
1.060853045,1959080,1902337,4649,15198,324,20181,56743,1882156,20200901,235
1.061062989,1937689,1879813,4472,14973,324,19946,57876,1859867,20200831,248
1.055542725,1924170,1866149,4313,14903,323,19698,58021,1846451,20200830,299
1.045608675,1909329,1855283,4209,14765,321,19399,54046,1835884,20200829,323
1.038428835,1887717,1837006,3931,14551,316,19076,50711,1817930,20200828,371
1.029139418,1869579,1817538,3584,14461,313,18705,52041,1798833,20200827,441
1.016524082,1849506,1796711,3348,14368,312,18264,52795,1778447,20200826,320
1.010659119,1825837,1775475,3136,14286,310,17944,50362,1757531,20200825,280
1.005678004,1804422,1756427,2889,14219,309,17664,47995,1738763,20200824,266
0.997808011,1791186,1743622,2524,14200,309,17398,47564,1726224,20200823,396
0.980862169,1775800,1733373,2241,14169,309,17002,42427,1716371,20200822,332
0.971401067,1754123,1716078,1976,14120,309,16670,38045,1699408,20200821,324
0.96204722,1734083,1699085,1746,14063,307,16346,34998,1682739,20200820,288
0.953539164,1715064,1684042,1521,14006,306,16058,31022,1667984,20200819,297
0.942743341,1697042,1671823,1293,13934,306,15761,25219,1656062,20200818,246
0.931548731,1688470,1665506,1103,13917,305,15515,22964,1649991,20200817,197
0.922892283,1681787,1659782,833,13910,305,15318,22005,1644464,20200816,279
0.909427349,1675296,1653678,705,13901,305,15039,21618,1638639,20200815,166
0.904160121,1665084,1644952,648,13863,305,14873,20132,1630079,20200814,103
0.902205119,1654898,1637100,623,13817,305,14770,17798,1622330,20200813,56
0.903099964,1646652,1629277,626,13786,305,14714,17375,1614563,20200812,54
0.904740011,1637844,1620355,663,13729,305,14660,17489,1605695,20200811,34
0.907372448,1628303,1611907,651,13658,305,14626,16396,1597281,20200810,28
0.907922209,1624650,1607847,629,13642,305,14598,16803,1593249,20200809,36
0.907623929,1620514,1604409,673,13629,304,14562,16105,1589847,20200808,43
0.909379024,1613652,1596584,696,13543,303,14519,17068,1582065,20200807,20
0.912773158,1606487,1588456,748,13501,302,14499,18031,1573957,20200806,43
0.915112202,1598187,1579697,770,13406,302,14456,18490,1565241,20200805,33
0.918044933,1589780,1571056,808,13352,301,14423,18724,1556633,20200804,34
0.920980878,1579757,1562356,806,13280,301,14389,17401,1547967,20200803,23
0.921796779,1576246,1558478,802,13259,301,14366,17768,1544112,20200802,30
0.922788552,1571830,1553552,821,13233,301,14336,18278,1539216,20200801,31
0.925610787,1563796,1545466,837,13183,301,14305,18330,1531161,20200731,36
0.928247973,1556215,1537197,882,13132,300,14269,19018,1522928,20200730,18
0.932668665,1547307,1527981,896,13069,300,14251,19326,1513730,20200729,48
0.93609533,1537704,1517260,971,13007,300,14203,20444,1503057,20200728,28
0.939859595,1526974,1508204,962,12905,299,14175,18770,1494029,20200727,25
0.94100466,1522926,1503712,928,12890,298,14150,19214,1489562,20200726,58
0.940122872,1518634,1498953,864,12866,298,14092,19681,1484861,20200725,113
0.938334022,1510327,1489768,883,12817,298,13979,20559,1475789,20200724,41
0.942115779,1500854,1479436,884,12758,297,13938,21418,1465498,20200723,59
0.943944175,1492071,1470320,877,12698,297,13879,21751,1456441,20200722,63
0.947257711,1482390,1458526,903,12643,296,13816,23864,1444710,20200721,45
0.950451069,1470193,1448891,894,12572,296,13771,21302,1435120,20200720,26
0.952301111,1465299,1443346,898,12556,295,13745,21953,1429601,20200719,34
0.953954028,1460204,1437281,919,12519,294,13711,22923,1423570,20200718,39
0.957485326,1451017,1427907,925,12460,293,13672,23110,1414235,20200717,60
0.959981494,1441348,1417944,914,12396,291,13612,23404,1404332,20200716,61
0.96241599,1431316,1408019,941,12348,289,13551,23297,1394468,20200715,39
0.967681639,1420616,1396327,986,12282,289,13512,24289,1382815,20200714,33
0.972183254,1408312,1386467,950,12204,289,13479,21845,1372988,20200713,62
0.972025206,1402144,1380314,941,12178,289,13417,21830,1366897,20200712,44
0.973296041,1396941,1373991,985,12144,288,13373,22950,1360618,20200711,35
0.97975338,1384890,1361363,987,12065,288,13338,23527,1348025,20200710,45
0.986230756,1371771,1347859,988,12019,287,13293,23912,1334566,20200709,50
0.991448819,1359734,1335722,982,11970,285,13243,24012,1322479,20200708,62
0.996658649,1346194,1322519,1005,11914,285,13181,23675,1309338,20200707,44
1.002438756,1331796,1310504,974,11848,284,13137,21292,1297367,20200706,48
1.003445246,1326055,1304406,934,11832,283,13089,21649,1291317,20200705,61
1.00431699,1319521,1297200,924,11811,283,13028,22321,1284172,20200704,63
1.008007302,1307761,1286201,938,11759,282,12965,21560,1273236,20200703,61
1.011142629,1295962,1276180,955,11684,282,12904,19782,1263276,20200702,54
1.015244468,1285231,1265705,980,11613,282,12850,19526,1252855,20200701,51
1.021504347,1273765,1252956,1046,11537,282,12799,20809,1240157,20200630,42
1.027584568,1259954,1241455,1069,11429,282,12757,18499,1228698,20200629,42
1.03148399,1251695,1232690,1054,11364,282,12715,19005,1219975,20200628,62
1.033814467,1243780,1223914,1148,11317,282,12653,19866,1211261,20200627,51
1.03849485,1232315,1213487,1307,11172,282,12602,18828,1200885,20200626,39
1.045541779,1220478,1201578,1324,10974,282,12563,18900,1189015,20200625,28
1.05482214,1208597,1188352,1295,10930,281,12535,20245,1175817,20200624,51
1.063614073,1196012,1173734,1277,10908,281,12484,22278,1161250,20200623,46
1.069785484,1182066,1162663,1273,10881,280,12438,19403,1150225,20200622,17
1.074116736,1176463,1156392,1237,10868,280,12421,20071,1143971,20200621,48
1.07644565,1170901,1149431,1191,10856,280,12373,21470,1137058,20200620,67
1.082442806,1158063,1136873,1177,10835,280,12306,21190,1124567,20200619,49
1.090482367,1145712,1123998,1145,10800,280,12257,21714,1111741,20200618,59
1.097599821,1132823,1111334,1117,10774,279,12198,21489,1099136,20200617,43
1.107885538,1119767,1097135,1114,10760,278,12155,22632,1084980,20200616,34
1.117219055,1105719,1084926,1089,10730,277,12121,20793,1072805,20200615,37
1.119955958,1100327,1078971,1082,10718,277,12084,21356,1066887,20200614,34
1.124748098,1094703,1071351,1056,10691,277,12050,23352,1059301,20200613,48
1.135217859,1081486,1057242,1016,10669,277,12002,24244,1045240,20200612,56
1.147117371,1066887,1041393,1014,10654,276,11946,25494,1029447,20200611,45
1.160226488,1051971,1025748,988,10611,276,11901,26223,1013847,20200610,50
1.175068441,1035996,1008537,977,10589,274,11851,27459,996686,20200609,38
1.188623107,1018213,993839,951,10563,273,11813,24374,982026,20200608,37
1.193971741,1012769,986288,915,10552,273,11776,26481,974512,20200607,57
1.199057452,1005305,977351,889,10531,273,11719,27954,965632,20200606,51
1.212645267,990960,962194,857,10506,273,11668,28766,950526,20200605,39
1.229724457,973858,945659,850,10499,273,11629,28199,934030,20200604,39
1.247595499,956852,928987,823,10467,273,11590,27865,917397,20200603,49
1.266948357,939851,910929,810,10446,272,11541,28922,899388,20200602,38
1.281909837,921391,897333,793,10422,271,11503,24058,885830,20200601,35
1.292128248,910822,887528,774,10405,270,11468,23294,876060,20200531,27
1.305151819,902901,876603,770,10398,269,11441,26298,865162,20200530,39
1.324946576,885120,860563,735,10363,269,11402,24557,849161,20200529,58
1.340429353,868666,846296,701,10340,269,11344,22370,834952,20200528,79
1.354267475,852876,831815,681,10295,269,11265,21061,820550,20200527,40
1.373204589,839475,817431,713,10275,269,11225,22044,806206,20200526,19
1.388001209,826437,807348,711,10226,267,11206,19089,796142,20200525,16
1.398826935,820289,799956,705,10213,266,11190,20333,788766,20200524,25
1.408209109,814420,792851,716,10194,266,11165,21569,781686,20200523,23
1.42456772,802418,782132,723,10162,264,11142,20286,770990,20200522,20
1.443300307,788684,770595,781,10135,264,11122,18089,759473,20200521,12
1.461684397,776433,760082,877,10066,263,11110,16351,748972,20200520,32
1.479732158,765574,748649,898,9938,263,11078,16925,737571,20200519,13
1.501116511,753211,737118,900,9904,263,11065,16093,726053,20200518,15
1.513713145,747653,729993,924,9888,262,11050,17660,718943,20200517,13
1.528031211,740645,722302,937,9851,262,11037,18343,711265,20200516,19
1.558698039,726747,706872,969,9821,260,11018,19875,695854,20200515,27
1.591141377,711484,690762,1008,9762,260,10991,20722,679771,20200514,29
1.62078005,695920,676341,1008,9695,259,10962,19579,665379,20200513,26
1.645600096,680890,664560,1021,9670,258,10936,16330,653624,20200512,27
1.658986876,668492,657570,1008,9632,256,10909,10922,646661,20200511,35
1.663306606,663886,653758,1016,9610,256,10874,10128,642884,20200510,34
1.665445238,660030,650877,1082,9568,256,10840,9153,640037,20200509,18
1.675242571,654863,645996,1135,9484,256,10822,8867,635174,20200508,12
1.686535332,649388,640959,1218,9419,256,10810,8429,630149,20200507,4
1.701501844,643095,635086,1267,9333,255,10806,8009,624280,20200506,2
1.711175063,640237,631379,1332,9283,254,10804,8858,620575,20200505,3
1.726102486,633921,625745,1360,9217,252,10801,8176,614944,20200504,8
1.734135623,630973,622385,1407,9183,250,10793,8588,611592,20200503,13
1.741332911,627562,619066,1454,9123,250,10780,8496,608286,20200502,6
1.753626397,623069,614384,1459,9072,248,10774,8685,603610,20200501,9
1.761153838,619881,611247,1593,9059,247,10765,8634,600482,20200430,4
1.776064962,614197,605890,1654,8922,246,10761,8307,595129,20200429,9
1.794060179,608514,599311,1731,8854,244,10752,9203,588559,20200428,14
1.811510464,601660,592765,1769,8764,243,10738,8895,582027,20200427,10
1.820508208,598285,589286,1843,8717,242,10728,8999,578558,20200426,10
1.829316166,595161,585902,1967,8635,240,10718,9259,575184,20200425,10
1.846461581,589520,579920,2051,8501,240,10708,9600,569212,20200424,6
1.865005786,583971,573832,2179,8411,240,10702,10139,563130,20200423,8
1.88994023,577959,565838,2233,8277,238,10694,12121,555144,20200422,11
1.913511364,571014,558293,2324,8213,237,10683,12721,547610,20200421,9
1.937015247,563035,551054,2385,8114,236,10674,11981,540380,20200420,13
1.949472083,559109,546866,2484,8042,234,10661,12243,536205,20200419,8
1.968098078,554834,541284,2576,7937,232,10653,13550,530631,20200418,18
1.998019828,546463,532277,2627,7829,230,10635,14186,521642,20200417,22
2.023423901,538775,524507,2750,7757,229,10613,14268,513894,20200416,22
2.038589022,534552,519526,2808,7616,225,10591,15026,508935,20200415,27
2.060114628,527438,512787,2873,7534,222,10564,14651,502223,20200414,27
2.08508129,518743,505352,2930,7447,217,10537,13391,494815,20200413,25
2.098903227,514621,500833,3026,7368,214,10512,13788,490321,20200412,32
2.111162368,510479,496409,3125,7243,211,10480,14070,485929,20200411,30
2.142477853,503051,487753,3246,7117,208,10450,15298,477303,20200410,27
2.175074395,494711,479202,3408,6973,204,10423,15509,468779,20200409,39
2.218116182,486003,468145,3445,6776,200,10384,17858,457761,20200408,53
2.262325524,477304,456654,3500,6694,192,10331,20650,446323,20200407,47
2.298054341,466804,447509,3591,6598,186,10284,19295,437225,20200406,47
2.317835811,461233,441662,3654,6463,183,10237,19571,431425,20200405,81
2.33531392,455032,434888,3867,6325,177,10156,20144,424732,20200404,94
2.371072072,443273,424365,3979,6021,174,10062,18908,414303,20200403,86
2.410488622,431743,413858,4155,5828,169,9976,17885,403882,20200402,89
2.441463644,421547,404962,4216,5567,165,9887,16585,395075,20200401,101
2.485825764,410564,393672,4275,5408,162,9786,16892,383886,20200331,125
2.531290694,395194,381663,4398,5228,158,9661,13531,372002,20200330,78
2.527742388,394141,379113,4523,5033,152,9583,15028,369530,20200329,105
2.552233541,387925,371361,4665,4811,144,9478,16564,361883,20200328,146
2.579739151,376961,361742,4966,4528,139,9332,15219,352410,20200327,91
2.635970254,364942,350573,5281,4144,131,9241,14369,341332,20200326,104
2.659057442,357896,343618,5410,3730,126,9137,14278,334481,20200325,100
2.712657065,348582,333142,5684,3507,120,9037,15440,324105,20200324,76
2.762262336,338036,324408,5884,3166,111,8961,13628,315447,20200323,64
2.804501324,331780,317240,6085,2909,104,8897,14540,308343,20200322,98
2.82195603,327509,311805,6325,2612,102,8799,15704,303006,20200321,147
2.873091828,316664,301139,6527,2233,94,8652,15525,292487,20200320,87
2.942085738,307024,291120,6789,1947,91,8565,15904,282555,20200319,152
3.012162506,295647,279301,6838,1540,84,8413,16346,270888,20200318,93
3.088057901,286716,269425,7024,1401,81,8320,17291,261105,20200317,84
3.173392208,274504,259533,7253,1137,75,8236,14971,251297,20200316,74
3.239660237,268212,251940,7300,834,75,8162,16272,243778,20200315,76
3.318000336,261335,243701,7402,714,72,8086,17634,235615,20200314,107
3.458499309,248647,230707,7470,510,67,7979,17940,222728,20200313,110
3.621744273,234998,217271,7407,333,66,7869,17727,209402,20200312,114
3.804174536,222395,203855,7212,288,60,7755,18540,196100,20200311,242
3.919308057,210144,191692,7165,247,54,7513,18452,184179,20200310,131
4.120339361,196618,179160,6954,166,51,7382,17458,171778,20200309,248
4.21775786,188518,169142,6605,130,50,7134,19376,162008,20200308,367
4.267542836,178189,158569,6134,118,44,6767,19620,151802,20200307,483
4.397234584,164740,142908,5643,108,42,6284,21832,136624,20200306,518
4.622748154,146541,124731,5255,88,35,5766,21810,118965,20200305,438
4.919985595,136707,108293,4750,41,32,5328,28414,102965,20200304,516
5.329139718,125851,90296,4159,34,28,4812,35555,85484,20200303,0
